D............#
###########..#
##########..##
#######....#.+
#........###.#
#........###.#
######.......#
##############
####$.########
#.........####
####.........#
##############