############D#
###########..#
###########..#
#............#
#....#########
#........##..#
######.......D
##############
####$.#####..#
#.........#..#
####.....##..#
##############