##############
#........#####
#........###.D
D............#
#..###...##.##
#........##.##
##...#####..##
#....####..###
#..####...#..#
#.......##...#
#..#####.....#
##############