####D#########
#............#
#..#######.###
D........#...+
#........#####
#..###...#####
#........#####
#..####...####
#..##...###.$#
#..#..####...#
#....##......#
###+##########