##D###########
#............#
#............#
D........###.+
#........#####
######...#####
#######..#####
#######...####
#####...###.$#
####..####...#
###..##......#
##############