##############
#............#
#..#########.#
D........#...+
#......#.###.#
#..#####.##..#
#........#...#
#..####....###
###########.$#
#$.#.....#..##
#....##......#
##############