##########
#........$
$........#
D........$
#........#
$.!......$
##########