####D#########
#........#####
#........#####
D............D
#..###...##.##
#........##.##
##...#####..##
#....####..###
#..####...#..#
#.......##...#
#..####......#
##############