##############
#............#
D............#
#........###.+
#........#####
######...#####
#######..#####
#######...####
#####...###.$#
####..####...#
###..##......#
##############