##############
###########..#
###########..#
D............D
#....#########
#........##..#
######.......#
##############
####$.#####..#
#............#
####.....##..#
##############