####D#########
#........#####
#........#####
#........#####
#..###...#####
#........#####
##############
##############
###########..#
##########...#
#######......#
##############