####D#########
#........#####
#..###########
#........#####
#........#####
#..###...#####
#........#####
#..####...####
#..##...###.$#
#..#..####...#
#....##......#
###+##########