###########..D
###########..#
#...#######..#
D........##..#
#........##..#
#........##..#
######.......#
##############
####..########
#.........####
####.........#
##############