##D###########
#........#####
#........#####
#........#####
#........#####
######...#####
#######..#####
#######...####
#####...###.$#
####..####...#
###..##......#
###.+#########