##############
#............#
#..#######.###
D........#...+
#........###.#
#..###...##..#
#........#...#
#..####...####
#..##...###.$#
#..#..####..##
#....##......#
##############