##############
#........$####
$........#####
D........$####
#........#####
$.!......$####
##########...#
##########.###
####..###..###
#.........####
####.........#
##############