##############
#........#####
#........#####
D........#####
#........#####
#.!......#####
##########...#
##########.###
####..###..###
#.........####
####.........#
##############