##############
#............#
#..#########.#
#........#...#
#......#.###.#
#..#####.##..#
#........#...#
#..####.....##
###########..#
#..#.....#..##
#....##......#
##############
