##############
###########..#
###########..#
D......####..+
#....######..#
#........##..#
#.####.......#
###########..#
####$.#####..#
#............#
####.....##..#
##############