##############
#........#####
#........#####
#...###......D
#.....#..#####
#.....#..#####
#...######...#
#...######...#
#........#...#
####....#$...#
#....####....#
##############