####D#########
#........#####
#........#####
#........#####
#..###...#####
#........#####
##...#########
#....#########
#..########..#
#..#######...#
#..####......#
##D###########