##############
#........#####
#........#####
D............D
#........#####
#.#......#####
##########...#
##########.###
####..###..###
#........$####
####.........#
##############