##############
###########..#
###########..#
#......####..#
#....######..#
#........##..#
D.####.......#
###########..#
####$.#####..#
#............#
####.....##..#
###########.D#