D............#
###########..#
###########..#
#######......#
#........#####
#........#####
######.......D
##############
####$.########
#.........####
####.........#
##############